_____________
_____________
_____________
_____________
____44444____
___4333334___
__433333334__
__433444334__
__444484444__
__488444884__
__488888884__
___4888884___
____44444____
_____________
_____________
_____________
_____________
_____________
