_____________
_____________
_____________
_____________
____88888____
___8333338___
__833333338__
__833888338__
__888808888__
__800888008__
__800000008__
___8000008___
____88888____
_____________
_____________
_____________
_____________
_____________